11111111111
1P0C00100E1
1000111C101
1C000000001
11111111111