1111111111
1P00C00001
1000000001
1000000001
1111111111