1111111111
1P00C00001
1011111101
100C1E00C1
1111111111