1111111111111111111111111111111111111111111111111111111111111111111111
1P0000000000C000000000000000000000000000000000000000000000000000000001
1000000000000000000000C00000000000000000000000000000000000000000000001
1000000000000000000000000000000000000000000000000000000000000000000001
1000000C00000000000000000000000000000000000000000000000000000000000001
1000011000011111111001111111100000000000100001100001111111100111111111
1000101000010000001001000000100000000001000010100001000000100100000011
1001001000010000001001000000100000000010000100100001000000100100000011
1000001000010000001001000000100000000100000000100001000000100100000011
100000100001000000100100000010C000001000000000100001000000100100000011
1000001000010000001001000000100000010000000000100001000000100100000011
100011111001111111100111111110000010000000001111100111111110E111111111
1111111111111111111111111111111111111111111111111111111111111111111111
