1111111111111111111111
1P00000000001101CE1111
1110111111101100011111
1C000000000C0001000C11
1111111111111111111111