1111111111111111111111111111111111
1P0000000000C000000000000000000001
1000000000000000000000C00000000001
1000000000000000000000000000000001
1000000C00000000000000000000000001
1000011000011111111001111111100001
1000101000010000001001000000100001
1001001000010000001001000000100001
1000001000010000001001000000100001
100000100001000000100100000010C001
1000001000010000001001000000100001
1000111110011111111001111111100001
1000000000000000000000000000000001
1000000000000000000100000000000001
1000000000000000001000000000000001
1000000000000000010000000000000001
1000000000000000100000000000000001
1000000000000001000000000000000001
1000000000000010000000000000000001
1000000000000100000000000000000001
1000000000001000000000000000000001
1000000000010000000000000000000001
1000000000000000000000000000000001
1000011000011111111001111111100001
1000101000010000001001000000100001
1001001000010000001001000000100001
1000001000010000001001000000100001
1000001000010000001001000000100001
1000001000010000001001000000100001
1000111110011111111001111111100001
1E00000000000000000000000000000001
1111111111111111111111111111111111