1111111111111
1P00000000001
1110111111101
1C000000000C1
1011111011101
1C000000000C1
1110111111101
1C000000000C1
1011111011101
1C000000000C1
1111111111E11