111111111111
1P0C0000E001
111111111111