1111111111111111111
1P000000000C00E0001
1111111111111111111