111111111111111
1P0000000010001
111011101111101
1C001C0000010C1
101111101110101
1C0000010000C01
101011101011111
1C000000C000001
111110111111101
1C0000100000C01
101111111101111
1C000000C1000E1
111111111111111
