1111111111
1P00000CE1
1111111111



